1111111111111
1P010P000P0C1
1000011111001
1P0011P000001
1111111111111
