1111111111111
1P010P000P0C1
10E0011111001
1P0011P0C0001
1111111111111
