1111111111111
1H010P000H0C1
1000011111001
1H0011E000001
1111111111111
