1111111111111
1C010P000C0C1
1000011111001
1C0011E000001
1111111111111
